111111111111111111
100000000000000E01
10000000000P000001
100000000000000K01
100000000000000001
100000000000000KK1
1000000000000000C1
111111111111111111