111111111111111111
1PKKK11111111100E1
1000000000000K0111
111K01100011000K01
1C001000KC11010001
1K10C000K0C1C10KK1
1C0C1000KKKKK100C1
111111111111111111