1111111111111
100E0000000P1
1000C00000001
1000C00000001
1000C00000001
1000C00000001
1000C00000001
1000C00000001
1000C00000001
1111111111111