1111111111111
100E1000000P1
1011C01111111
1001011C00001
11C101C111101
100101001C001
1011011011001
101101001C011
1000000000111
1111111111111